# Instrumental
1lycZ6BCUETp0NauGdZbsm	Scott Benson Band - Requiem for a Dream
69Yia3qCLw6N9U80WhLwLn	Death - Voice of the Soul
2hzjnKiuRM3qp1D6pAv60D	Christopher Lawrence - Rush Hour: 
4PcWmwzAaLCPRgJSq0uZEo	Sin - Hard Ebm:
14JJgiD5VDRpMOuTm9AE5J	Blackmill - The Drift: Nothing found
7svPsdes3vQESrTJrpQ1cj	Peter Gundry - Folkvangr
4bqEnLbbYi8bsMtn7qsm4h	Peter Gundry - Malleus Maleficarum:
14rZjW3RioG7WesZhYESso	Yann Tiersen - Comptine d'un autre été, l'après-midi: Nothing found
39TNsojSjrTcpA8fPAnSIE	Carl Orff - Carmina Burana: I Fortuna Imperatrix Mundi: O Fortuna: Nothing found
2afx7sZttPusX6WNJdQecw	Carl Orff - Orff: Carmina Burana, Conclusion, Fortuna Imperatrix Mundi: O Fortuna: Nothing found
2oLjhx7w8Hyd3gry9cCXr7	Johannes Brahms - 21 Hungarian Dances, WoO 1: Hungarian Dance No 5 
24V9V4erGgsbLeSa7tlimK	Steve Jablonsky - My Name Is Lincoln: Nothing found
59NB4aFUAVG4lM6p7jsEas	Johan Skugge - Battlefield 3 Main Theme: Wrong lyrics found.
2V80yrnLBbCUrGNi4CWBu3	Johan Söderqvist - Battlefield Classic Theme / Mayhem View: Nothing found
255miasxqoO3ZsQmVBCphI	Geek Music - Battlefield 1942: Wrong lyrics found. 
0Dkibk70FDp6t7eOZNemNQ	Ludovico Einaudi - Una Mattina: Nothing found
4BMHp3DkI8VLsuB9Kr0pzu	Ludovico Einaudi - Primavera: Nothing found
6KpO4neDXxGdiEgsivZieY	Ludovico Einaudi - Divenire: Nothing found
1YtHpYEbbfQQIyxXkdxEoW	Thomas Bergersen - Protectors of the Earth: Nothing found
0G8iyOJFQ8Wvm4Fe6xjQdr	Thomas Bergersen - Dragon Rider: Nothing found
4FvOXcUhFu2RVyfxq1gJgH	Thomas Bergersen - Secret Melody
5n4dHCWjvGJtuFSZIyeqWp	Thomas Bergersen - Winterspell: Nothing found
3pTNVDJpzaLxiZnbC18SMX	Thomas Bergersen - Archangel: Nothing found
3AnYGQ8PB3lYrA6ToVUXa3	Thomas Bergersen - Empire of Angels: Nothing found
1GMfOx8IyUnQz4SX1Mhqlo	Two Steps from Hell - Bravestone: Nothing found
0KMcHh8Npw6a3atnnHoYXK	Two Steps from Hell - Northern Pastures: Nothing found
2LNaHOlGadVUkhiIUwc5Bs	Two Steps from Hell - Unbreakable: Wrong lyrics found. Found: DC Extended Universe - Wonder Woman Script
3DTQa2baLEfkftbefDQVIJ	Two Steps from Hell - Stormkeeper (Orchestral): Nothing found
3yHsURe0ltdfD1NDDk5PWn	Lindsey Stirling - Afterglow: Nothing found
3zxynusRvxKwOCCWMmbEzR	Lindsey Stirling - Anti Gravity: Nothing found
5ky71GXSi2Rt2sgmbVGuqK	Lindsey Stirling - The Arena: Nothing found
69yWkTRy6JWuJaPRKOatQ6	Lindsey Stirling - Ascendance: Nothing found
6gjhYAsYpDnRDWr2tFjHmY	Lindsey Stirling - Crystallize: Nothing found
6dDjXb5JqiistQAIiGoDg3	Lindsey Stirling - Elements: Nothing found
5B2KrwP88LtwuspnsGEOkn	Lindsey Stirling - Gavi's Song: Nothing found
5QvgayvMzeKSJHebWYbT2T	Lindsey Stirling - Heist: Nothing found
3bXx16ksTSyUXjRJw9hkbk	Lindsey Stirling - Master Of Tides: Nothing found
0oXcxob92js3oGFVJlPpeu	Lindsey Stirling - Minimal Beat: Nothing found
22LHIaxcDvOuBkKcKTM226	Lindsey Stirling - The Phoenix: Nothing found
3chN3fwZZDJO9LES2g0TDS	Lindsey Stirling - Powerlines: Nothing found
7plqlR090X9rjj23xn5p4g	Lindsey Stirling - Roundtable Rival: Nothing found
4wfs0HxuifzNkm5VxZRYJr	Lindsey Stirling - Shadows: Nothing found
6M1o8ZVaO6ziHQyc4dD6Fs	Lindsey Stirling - Song Of The Caged Bird: Nothing found
4vpBLp3Wm2VBwSXdLEln0U	Lindsey Stirling - Spontaneous Me: Nothing found
6XQ0DQ5oZUndgL4OeUcrsR	Lindsey Stirling - Take Flight: Nothing found
4NYT1gH4fRjsUhxECL0bw7	Lindsey Stirling - Transcendence: Nothing found
2lbT91nOdaRd6iTt3UtsQ6	Lindsey Stirling - V-Pop: Nothing found
6Ct38LR16in3oqNoIq8k0V	Lindsey Stirling - Waltz: Nothing found
0BNn5xt2Hl6DuXwz4Ga7Fc	Lindsey Stirling - Zi-Zi's Journey: Nothing found
2SOWmT6rFUSBLYoIvCgRif	Lindsey Stirling - Forgotten Voyage: Nothing found
7LJmj6xdGeYExboeBv4FzH	Lindsey Stirling - Mirror Haus: Nothing found
4AD2dterIUjNt1LFNI9Bvi	Klaus Badelt - He's a Pirate: Nothing found
6ZFbXIJkuI1dVNWvzJzown	Hans Zimmer - Time: Nothing found
0PV1i5jDLQi9OmISDw84rU	Hans Zimmer - Singapore: Nothing found
4aaJhwVcYWgHz05xFXRug4	Hans Zimmer - At Wit's End: Nothing found
0d6y8TbNBN0iWuPEfNM4sb	Hans Zimmer - Multiple Jacks: Nothing found
5eZiC96lRq6IPHEOnbw0KS	Hans Zimmer - Up Is Down: Nothing found
2aHSSEvVKoR6QINGvpnsBy	Hans Zimmer - I See Dead People in Boats: Nothing found
5m15scImMtloyll7WlAmOn	Hans Zimmer - The Brethren Court: Nothing found
4xqTq5yjI5BNcU8Hkqzxjr	Hans Zimmer - Parlay: Nothing found
3WzWQ16x6zEU1zSs0eLFbn	Hans Zimmer - Calypso: Nothing found
5sbwYsgzeg7wsug1A1pTiO	Hans Zimmer - I Don't Think Now Is the Best Time: Nothing found
2wbN4OiwGcUXXpR6xKkugA	Hans Zimmer - One Day: Nothing found
5tmhUzJuP7XwqCHglyqnt8	Marcin Przybyłowicz - Geralt Of Rivia: Nothing found
1frGIyTaTjvksS8FhyoqYx	Marcin Przybyłowicz - Eredin, King Of The Hunt: Nothing found
0Kj4xPVUgSzfYxfLY96xBl	Mikolai Stroinski - Wake Up, Ciri: Nothing found
7szFQ4HWhfQwd5mDq2UKE4	Mikolai Stroinski - Aen Seidhe: Nothing found
5RXvFWyBAfhQThqCggHqtJ	Mikolai Stroinski - Commanding The Fury: Nothing found
2j9dq1WtTUvexDuDPfMWsq	Marcin Przybyłowicz - Emhyr Var Emreis: Nothing found
3Hb9YjZLYBLikxJ1kd4BMa	Mikolai Stroinski - Spikeroog: Nothing found
5bhZCxZo9ejcqInKNvbL73	Marcin Przybyłowicz - King Bran's Final Voyage: Nothing found
1e6i6WC1SW5w6e5u5izQ19	Percival Schuttenbach - Silver For Monsters: Nothing found
0HLQFjnwq0FHpNVxormx60	Percival Schuttenbach - The Nightingale: Nothing found
5NpbqVY5C54NDRqtK6AVLT	Mikolai Stroinski - City Of Intrigues: Nothing found
7GfoGMbKkDnY3e44ahZarZ	Marcin Przybyłowicz - The Hunter's Path: Nothing found
761SMhVKJlJlUCUveNcq1m	Marcin Przybyłowicz - Kaer Morhen: Nothing found
3IV2tUetZP5Wbdk5GHxalF	Mikolai Stroinski - Witch Hunters: Nothing found
1asBfrlvpH0Brn6xcD7yms	Percival Schuttenbach - Steel For Humans: Nothing found
6ZYWXmwrDehLhGW355yKIc	Mikolai Stroinski - Fate Calls: Nothing found
0Lc3coQTcMMJiiEFi7BG2z	Marcin Przybyłowicz - The Vagabond: Nothing found
5U4AHSNYR1Z3Hu0K6x1QxC	Percival Schuttenbach - Cloak And Dagger: Nothing found
6tSqyn7JhHxyLbwG8zGu2T	Mikolai Stroinski - Yes, I Do: Nothing found
1EeYiq16eXGD0OAJNFmGXQ	Mikolai Stroinski - Welcome, Imlerith: Nothing found
773n5N7v7ZFhqpIc6vy7Wz	Percival Schuttenbach - Drink Up, There's More!: Nothing found
4DxxiT2TskPH0Xd6znaqZM	Mikolai Stroinski - After The Storm: Nothing found
1cGKXQBjdlCexM5Arq6iGQ	Mikolai Stroinski - Blood On The Cobblestones: Nothing found
554gPYGKoueKOCXvUw8fwS	Marcin Przybyłowicz - Farewell, Old Friend: Nothing found
2k6KTdwvApSUnN0maOmIFb	Percival Schuttenbach - The Song Of The Sword-Dancer: Nothing found
5RCUcFJcJTeCswnKIGH22l	Marcin Przybyłowicz - The Hunt Is Coming: Nothing found
26p3Z6JmI7fuoWErxcvBG8	Marcin Przybyłowicz - Family Matters: Nothing found
5cXOHXgaR9DY9Ulb893Go3	Mikolai Stroinski - No Surrender: Nothing found
4vFccE7ymnD9ureATGgPEI	Marcin Przybyłowicz - Child Of The Elder Blood: Nothing found
1B031n8CmpDxhcmXTZlUPE	Marcin Przybyłowicz - In The Giant's Shadow: Wrong lyrics found. Found: Genius - October 2023 Album Release Calendar
0ii63pLseSLS1vpeatX02w	Mikolai Stroinski - Nemesis: Nothing found
6l4xX3N7JQH5FAMgFXWsrU	Mikolai Stroinski - Bonnie At Morn: Nothing found
0q3BKRWzQ9uof4ywERwtB0	Marcin Przybyłowicz - Back On The Path: Nothing found
34nfkCbhJhLfSAbBx0RGgW	Marcin Przybyłowicz - Words On Wind: Nothing found
1K01nmx3aMH7pkDB7O6rS9	Marcin Przybyłowicz - A Story You Won't Believe: Nothing found
3p3Zz3cPhPII3x1r7tCfvX	Mikolai Stroinski - When No Man Has Gone Before: Nothing found
2g9UTcYcFqe8PLGcfFexJb	Mikolai Stroinski - Like A Wounded Animal: Nothing found
1UiiNExaBWS3nfKDf6P1wr	Marcin Przybyłowicz - I Name Thee Dea And Embrace Thee As My Daughter: Nothing found
4UQvEa8gWx8PH6PPkMYwpk	Mikolai Stroinski - Igni: Nothing found
6B7wSqeVtMrtXbQBgzzVqa	Mikolai Stroinski - The Tree When We Sat Once: Nothing found
1fGKoRw3qvyMn2nb1foF9e	Marcin Przybyłowicz - Go For It: Nothing found
51ZflqPt0Y2tagl6vqjIXK	Mikolai Stroinski - The Wolf And The Swallow: Nothing found
5TjKVg63SZDjGq5EQKXEVx	Mikolai Stroinski - On Thin Ice: Nothing found
0whhUScEFSwmSEnQwCqC4W	Mikolai Stroinski - Trial Of The Grasses: Nothing found
555JmMePfbDB0dhyjYEYA5	Marcin Przybyłowicz - Hjalmar's Axe: Nothing found
245YMmRFEYMSBDgx2bPpT0	Marcin Przybyłowicz - The Big Four: Nothing found
5nhaRM1ZqVt67Ot4wYTOMV	Mikolai Stroinski - The Shrieker Contract: Nothing found
1SoyOLhVSo2fWJaeyEhMaC	Marcin Przybyłowicz - The Possesion Of Jarl Udalryk: Nothing found
6SVHkVhU0hdXM3q8lCPqGh	Marcin Przybyłowicz - Another Round For Everyone: Nothing found
2eOHlZV94DlYx0GJMyjIp6	Marcin Przybyłowicz - Conjunction Of The Spheres: Nothing found

# Other